###########
###########
##########
###########
##.....####
##..@..####
###########
##########
###########
###########