###########
###########
.#########.
....###....
.....@.....
....###....
...#####...
..#######..
.#########.
###########